## Main Section ######################################################
Main=pet.common.MainController
## Member Section ####################################################
mLogin=pet.member.MemberLoginController
mLogout=pet.member.MemberLogOutController
mFindId=pet.member.MemberFindIdController
mFindPassword=pet.member.MemberFindPasswordController
mSignUp=pet.member.MemberSignUpController
mIDCheck=pet.member.MemberIDCheckController
mNicknameCheck=pet.member.MemberNickCheckController
mModify=pet.member.MemberModifyController
mDelete=pet.member.MemberDeleteController
mList=pet.member.MemberListController
## Free Board Section  ####################################################
FBList=pet.board.free.FBListController
FBWrite=pet.board.free.FBWriteController
FBDetailView=pet.board.free.FBDetailViewController
FBDelete=pet.board.free.FBDeleteController
FBModify=pet.board.free.FBModifyController
FBReply=pet.board.free.FBReplyController
FBCList=pet.board.free.FBCListController
FBCModify=pet.board.free.FBCModifyController
FBCDelete=pet.board.free.FBCDeleteController
FBCWrite=pet.board.free.FBCWriteController
## Image Board Section  ####################################################
IBList=pet.board.image.IBListController
IBWrite=pet.board.image.IBWriteController
IBDetailView=pet.board.image.IBDetailViewController
IBDelete=pet.board.image.IBDeleteController
IBModify=pet.board.image.IBModifyController
IBCList=pet.board.image.IBCListController
IBCModify=pet.board.image.IBCModifyController
IBCDelete=pet.board.image.IBCDeleteController
IBCWrite=pet.board.image.IBCWriteController
## Inquiry Board Section  ####################################################
QBList=pet.board.inquiry.QBListController
QBWrite=pet.board.inquiry.QBWriteController
QBDetailView=pet.board.inquiry.QBDetailViewController
QBDelete=pet.board.inquiry.QBDeleteController
QBModify=pet.board.inquiry.QBModifyController
QBReply=pet.board.inquiry.QBReplyController
QBCWrite=pet.board.inquiry.QBCWriteController
QBCList=pet.board.inquiry.QBCListController
QBCDelete=pet.board.inquiry.QBCDeleteController
QBCModify=pet.board.inquiry.QBCModifyController
LikeUpdate=pet.board.inquiry.LikeUpdateAction
## Product Section  ####################################################
PRAdd=pet.product.PRAddController
PRDelete=pet.product.PRDeleteController
PRModify=pet.product.PRModifyController
PRList=pet.product.PRListController
PRDetailView=pet.product.PRDetailViewController
adminPRList=pet.product.adminPRListController
## Order Section  ####################################################
CartHistory=pet.order.CartHistoryController
CartAdd=pet.order.CartAddController
CartDelete=pet.order.CartDeleteController
CartModify=pet.order.CartModifyController
CartList=pet.order.CartListController
PRCalculate=pet.order.PRCalculateController
ORDetailView=pet.order.ORDetailViewController
ORList=pet.order.ORListController